alias ..='cd ..;ll'
alias f='find . -name '
alias fa='find /c -name '
alias ga='git add '
alias gb='git branch -vv'
alias gbb='gb -vv | grep -e behind -e ahead '
alias gc='git commit'
alias gd='git diff'
alias gdel='git br -D '
alias gf='git fetch'
alias gff='echo Running git fetch...; gf; echo; echo; echo Running git branch -vv; gb -vv|grep -e behind -e ahead'
alias gh='git hist -n 15'
alias gha='git hist --all '
alias ghs='git hist --stat'
alias gk='gitk --all&'
alias gl='git log'
alias gm='git co master'
alias go='git checkout '
alias gs='git status '
alias gss='git status -s'
alias hist='git hist'
alias j='jconsole.exe &'
alias jr='cd ~/Dropbox/Solbon\ stuff/study/java/javarush/JavaRushHomeWork'
alias la='ls -altr'
alias ll='ls -l'
alias ls='ls -F --color=auto --show-control-chars'
alias s='source ~/.bashrc; w'
alias vb='vi ~/.bashrc'
alias w='cd ~/workspace/csshi'
alias ww='cd ~/Dropbox/Solbon\ stuff/study/java/workspace; ll'
